"skaters","gp","g","a","pts","pim"
"c. lewis","24","28","21","49","44"
"j. recupero","24","19","26","45","28"
"j. zitarelli","24","10","18","28","10"
"p. kinch","21","10","18","28","18"
"f. reluzco","23","13","9","22","20"
"b. snow","19","12","8","20","10"
"r. seifert","22","13","5","18","12"
"tj laessig","23","5","13","18","8"
"n. laessig","18","6","10","16","2"
"f. linge","17","5","11","16","10"
